0 3 2 3 0 
3 2 0 2 1 
1 0 1 0 3 
1 2 0 2 3 
0 1 0 3 0 