-99 -99 1 3 2 3 2 -99 -99 
-99 -99 1 2 3 2 0 -99 -99
-11 20 -11 -11 -11 -11 -11 30 -11
-99 -99 -11 -11 -11 -11 -11 -99 -99 
-11 31 -11 -11 -11 -11 -11 21 -11
-99 -99 -11 -11 -11 -11 -11 -99 -99 
-11 22 -11 -11 -11 -11 -11 32 -11
-99 -99 -11 -11 -11 -11 -11 -99 -99 
-11 33 -11 -11 -11 -11 -11 23 -11
