-99 -99 -99 0 -11 1 -99 -99 -99
-99 -99 0 0 1 0 2 -99 -99
-99 -99 -99 3 -11 2 -99 -99 -99
-99 -11 3 2 32 3 2 -11 -99
-11 -11 -11 1 31 2 -11 -11 -11
-11 -11 -11 -11 1 -11 -11 -11 -11
-11 -11 -11 -11 -11 -11 -11 -11 -11
-99 -11 -11 -11 -11 -11 -11 -11 -99