3 -99 -99 -99 -99 -99 -99 -99 2
0 3 -11 -11 -99 -11 -11 1 0
3 -11 -11 -11 3 -11 -11 -11 2
-99 -11 -11 -11 12 -11 -11 -11 -99
-99 -11 -99 -11 -10 -11 -99 -11 -99
-99 -11 -11 -11 -11 -11 -11 -11 -99
-11 -11 -11 -11 11 -11 -11 -11 -11
-11 -11 -11 -11 -99 -11 -11 -11 -11
1 -11 -11 -11 -11 -11 -11 -11 1