-99 -99 -99 -99 -21 -99 -99 -99 -99
-99 -99 -99 0 1 0 -99 -99 -99
-99 -99 0 0 3 1 1 -99 -99
-99 10 3 3 2 3 3 12 -99
-21 1 2 3 1 2 2 1 -21
1 1 0 0 1 3 0 2 1
0 0 2 1 -21 0 3 1 1
33 3 1 3 0 1 1 0 33