-99 -99 -99 0 3 0 -99 -99 -99
-99 -99 -11 -11 0 -11 -11 -99 -99
-99 -11 -11 2 2 1 -11 -11 -99
-11 -11 -11 2 3 3 -11 -11 -11
-11 -11 -11 0 3 1 -11 -11 -11
-11 -11 -11 2 1 2 -11 -11 -11
-99 -11 -11 -11 -11 -11 -11 -11 -99
-99 -99 -11 -11 -11 -11 -11 -99 -99
-99 -99 -99 -11 -11 -11 -99 -99 -99
