-99 2 3 3 30 3 2 2 -99
-99 2 1 0 2 0 1 2 -99
-99 -99 3 3 1 3 2 -99 -99
-99 -99 -99 2 20 2 -99 -99 -99
-99 -99 0 1 3 1 3 -99 -99 
-99 1 2 2 1 2 3 2 -99
3 2 0 3 3 1 2 3 1
2 1 1 2 0 2 1 2 2
0 31 1 3 21 2 1 32 2

