-99 1 0 0 -99  0 3 3 -99
2 0 2 2 0 1 1 3 0
1 2 2 3 2 1 0 1 3
2 3 3 0 3 2 1 0 2
-99 -11 0 -11 2 -11 2 -11 -99
-99 -99 -11 -11 1 -11 -11 -99 -99
-99 -99 -99 -11 1 -11 -99 -99 -99
-99 -99 -99 -99 3 -99 -99 -99 -99
