-99 1 3 -11 -11 -11 1 3 -99
32 3 2 3 -11 1 2 3 32
-11 0 2 -11 -99 -11 1 0 -11
-11 0 -11 -99 -99 -99 -11 2 -11
-11 3 -11 -99 -99 -99 -11 3 -11
-11 3  2 -11 -99 -11 0 2 -11
-11 2 3 22  7 20 1 2 -11
-11 2 1 3 -99 2 0 3 -11
-99 -99 -11 3 2 1 -11 -99 -99