-99 31 2 0 -11 1 0 33 -99
-99 -11 1 2 7 3 2 -11 -99
-99 -11 1 3 30 1 -11 -11 -99
-11 -11 -11 2 1 2 -11 -11 -11
0 1 -11 -11 0 -11 -11 1 0
3 2 2 -11 -99 -11 2 2 3
-11 0 1 3 -11 3 1 0 -11
-99 -11 3 32 -99 32 3 -11 -99
-99 -99 0 -11 -99 -11 0 -99 -99