-11 -11 -11 1 13 -99 -99 -21 -99
-11 -11 -11 -11 -11 -99 -99 -21 -99
1 -11 -21 -11 -21  -99 -21 1 -21
-11 -11 -11 -11 -11 -99 -11 -99 -11
-11 23 -11 -21 11 -99 -99 -11 -99
12 -11 -11 -11 -11 -99 -11 -99 -11
-21 -11 -11 -11 -11 -99 -99 7-99
-11 -11 -11 -11 -11 -99 -99 11-99
-11 -11 -11 10 -11 -99 -99 -99 -99