0 1 2 3 0 2 1 
3 4 0 2 1 5 3
1 0 1 5 3 2 1
1 2 0 2 5 0 1
0 4 2 3 0 1 5
2 3 1 4 0 3 0
0 1 2 0 1 4 1