-99 -99 -11 1 -11 -99 -99 
-99 -99 1 2 1 -99 -99 
-99 -11 -11 1 -11 -11 -99 
-99 -11 -11 11 -11 -11 -99 
0 -11 1 -11 2 -11 22 
3 -11 2 -11 1 -11 3 
0 -11 -11 -11 -11 -11 3 
-99 -11 -11 12 -11 -11 -99 