-99 -99 -99 1 2 3 2 4
-99 -99 -11 -11 -11 3 -11 2 
-99 -11 -11 -11 3 2 3 3
-11 -11 -11 -11 -11 -11 -11 2
10 -11 -11 11 -11 -11 -11 1
-11 -11 -11 -11 -11 -11 -11 -99
-11 -11 -11 -11 -11 -11 -99 -99
14 -11 -11 10 -11 -99 -99 -99