-11 0 -11 -11 -11 0 -11 
0 -11 -11 -11 -11 -11 0 
-11 -11 -11 4 -11 -11 -11 
0 -11 -11 4 -11 -11 0 
-11 -11 4 0 -11 -11 -11 
0 -11 -11 4 -11 -11 0 
-11 0 -11 4 -11 0 -11 