5 5
0 3 0 3 0 
3 0 2 1 2
1 0 23 22 1
0 1 0 0 1
0 1 1 2 0

0 0 0 0 0
0 0 0 0 0
0 0 0 0 0
0 0 0 0 0
0 0 0 0 0