5 5
0 3 1 3 0
3 2 -11 2 1
1 0 -12 2 3
1 2 1 0 1
0 1 0 1 2

0 0 0 0 0
0 0 0 0 0
0 0 0 0 0
0 0 0 0 0
0 0 0 0 0