5 5
0 3 -1 3 2 
3 2 -1 2 1
1 0 1 3 2
1 0 3 0 1
0 1 0 1 2

0 0 0 0 0
0 0 0 0 0
0 0 0 0 0
0 0 0 0 0
0 0 0 0 0